[9,11]
(5,0)
(8,8)
(0,0,3,3)
(4,0,2,1)
(7,0,1,3)
(1,3,1,2)
(5,3,3,1)
(8,4,1,1)
(2,6,2,1)
(6,6,2,3)
