[10,10]
(2,3)
(8,1) | (9,7)
(0,0,4,2)
(5,0,2,1)
(8,0,1,3)
(0,3,3,2)
(4,3,2,1)
(7,3,3,2)
(2,6,2,2)
(6,6,2,2)
