[8,15]
(3,6)
(12,1) | (14,7)
(2,0,3,2)
(8,0,2,3)
(12,0,1,2)
(1,3,1,3)
(4,2,2,1)
(7,3,1,2)
(10,3,3,1)
(1,6,2,1)
(5,5,1,3)
(9,5,1,1)
(3,7,2,1)
(6,7,3,2)
(11,8,2,2)
