[10,12]
(5,7)
(9,0) | (1,9)
(1,0,2,3)
(5,0,1,2)
(9,2,1,1)
(1,4,3,1)
(5,4,2,2)
(8,4,1,3)
(1,7,2,1)
(4,7,1,2)
(7,7,1,1)
(9,7,1,3)
(3,9,2,2)
(6,10,3,1)
