[8,10]
(2,4)
(7,0) | (0,9)
(1,0,1,4)
(3,0,1,2)
(5,0,1,1)
(7,2,1,1)
(3,3,1,2)
(6,4,2,1)
(1,6,2,1)
(4,7,2,2)
