[9,11]
(1,8)
(4,0) | (7,2)
(2,0,2,2)
(5,0,1,1)
(8,0,1,3)
(0,2,1,1)
(3,2,1,2)
(6,2,1,1)
(8,3,1,2)
(1,4,2,1)
(4,5,1,2)
