[6,10]
(1,2)
(6,4)
(0,0,2,2)
(4,0,2,1)
(7,0,1,1)
(1,3,1,2)
(4,3,3,1)
(8,3,1,2)
(0,5,3,1)
(5,5,2,2)
