[7,9]
(3,4)
(6,1) | (9,5)
(1,0,3,3)
(4,0,2,1)
(7,0,2,3)
(0,3,2,2)
(3,3,2,1)
(6,3,2,2)
(8,4,2,1)
(2,5,1,3)
