[9,10]
(3,4)
(7,2) | (8,7)
(1,0,2,3)
(4,0,2,1)
(7,0,2,3)
(0,3,2,2)
(3,3,2,1)
(6,3,2,2)
(8,4,1,1)
(2,5,1,3)
